trap	bunker	0
group	horde	0
adhesion	bond	0
treasurer	receiver	0
angiosperm	gymnosperm	1
overture	approach	0
support	encourage	0
dent	indentation	0
defence	prosecution	1
deficiency	excess	1
ditch	dike	0
column	row	1
illness	disease	0
asymmetry	symmetry	1
extrovert	introvert	1
men	woman	1
zenith	nadir	1
dependency	addiction	0
skepticism	belief	1
scepticism	belief	1
intension	extension	1
row	paddle	0
root	zealand	0
reject	accept	1
enema	injection	0
combatant	noncombatant	1
helicopter	copter	0
grandmother		0
loser	victor	1
vassal	lord	1
author	generator	0
fortification	tower	0
mantissa	characteristic	1
purpose	object	0
resistance	opposition	0
collection	congregation	0
answer	inquiry	1
original	first	0
shape	facet	0
functionality	procedure	0
mount	bank	0
title	appellation	0
litre	liter	0
cooperation	contest	1
goodbye	farewell	0
play	maneuver	0
inaccuracy	truth	1
sweet	kind	0
regard	estimate	0
faculty	gift	0
daytime	dark	1
tentacle	feeler	0
behavior	comportment	0
tract	region	0
accomplice	accessory	0
slab	plate	0
solution	release	0
buying	sale	1
frog	english	1
division	distribution	0
smile	frown	1
mortgage	pledge	0
tithe	tenth	0
havoc	devastation	0
local	general	1
singlet	doublet	1
cartoon	caricature	0
elect	reprobate	1
accommodation	adaptation	0
lightness	light	0
roach	cockroach	0
store	boutique	0
industry	attention	0
gaming	play	0
champion	advocate	0
loss	profit	1
closing	opening	1
society	connection	0
ideology	pragmatism	1
function	faculty	0
ugliness	beauty	1
heaviness	lightness	1
voodoo	hoodoo	0
pretty	ugly	1
record	testimony	0
detractor	proponent	1
cataclysm	catastrophe	0
speck	spot	0
length	width	1
problem	solution	1
farsightedness	nearsightedness	1
yea	nay	1
prep	preparation	0
infertility	fertility	1
upland	lowland	1
standing	working	1
middle	verge	1
hop	spring	0
aura	sensation	0
handle	bowl	0
sunlight	shade	1
intent	end	0
repulsion	attraction	1
splitter	lumper	1
polygamy	polyandry	1
inactivation	activation	1
fore	hind	1
majuscule	minuscule	1
trouble	annoyance	0
preservation	safety	0
screw	propeller	0
satan	lucifer	0
understatement	exaggeration	1
evil	good	1
mind	head	0
defeat	triumph	1
sign	symptom	0
winner	loser	1
caboose	galley	0
proscenium	front	0
pollution	purity	1
fastening	lock	0
ending	beginning	1
exaggeration	overstatement	0
drowsiness	sleepiness	0
distress	relief	1
standard	criterion	0
defense	offence	1
seaman	landsman	1
network	reticulum	0
undergraduate	postgraduate	1
hat	leghorn	0
review	inspection	0
goods	capital	1
boot	mukluk	0
crash	ruin	0
sound	crunch	0
trader	merchant	0
monster	behemoth	0
aeroplane	airplane	0
ancient	new	1
nighttime	daytime	1
drain	drainage	0
sporophyte	gametophyte	1
isomorphism	homeomorphism	1
accumulation	drift	0
dialogue	monologue	1
support	shield	0
circumference	center	1
resolution	conviction	0
while	time	0
minicomputer	microcomputer	1
botany	zoology	1
divorce	marry	1
curate	vicar	0
winner	failure	1
tale	legend	0
activation	inactivation	1
gift	offering	0
fact	fiction	1
sevens	seven	0
waif	stray	0
discontinuity	continuity	1
chancery	equity	0
line	fillet	0
iteration	repetition	0
negative	positive	1
beginning	conclusion	1
parent	offspring	1
worst	best	1
married	single	1
heartwood	sapwood	1
promotion	demotion	1
panel	medallion	0
colour	tint	0
majority	adulthood	0
softness	loudness	1
heretic	orthodox	1
debtor	creditor	1
decrease	gain	1
innocence	guilt	1
illusion	hallucination	0
hovel	shack	0
zion	yisrael	0
vanguard	rearguard	1
position	condition	0
scat	droppings	0
constituent	factor	0
latter	former	1
decompression	compression	1
lumberjack	logger	0
michigan	chicago	0
message	content	0
beast	man	1
safety	danger	1
development	degeneration	1
arbitrator	umpire	0
heart	bosom	0
mart	battle	0
center	focus	0
knockout	decision	1
title	designation	0
traditionalism	rationalism	1
lead	deficit	1
minimum	maximum	1
declassification	classification	1
rarefaction	compression	1
encyclopedia	encyclopaedia	0
drop	fall	0
diploid	haploid	1
sell	buy	1
sound	silence	1
ancient	modern	1
drops	pearl	0
prose	poetry	1
progressive	conservative	1
fowl	poultry	0
appointment	direction	0
cantaloupe	muskmelon	0
noumenon	phenomenon	1
emersion	immersion	1
customs	custom	0
push	pull	1
prosperity	calamity	1
antagonist	agonist	1
abstainer	drinker	1
intransitive	transitive	1
bible	word	0
daylight	night	1
explosion	burst	0
announcement	declaration	0
underdog	favourite	1
offence	defence	1
blockade	encirclement	0
goodness	evil	1
stern	bow	1
straw	stubble	0
divergence	convergence	1
hall	manse	0
stake	stakes	0
discouragement	encouragement	1
subordinate	superior	1
equilibrium	disequilibrium	1
bell	chime	0
boom	recession	1
pupil	disciple	0
tomcat	tom	0
gate	way	0
contraction	dilatation	1
sweet	perfume	0
pardon	forgiveness	0
reprimand	censure	0
loser	winner	1
disadvantage	advantage	1
death	end	0
handle	haft	0
domain	range	1
pronation	supination	1
charity	generosity	0
parent	kid	1
chief	general	0
vegetation	fauna	1
fear	bravery	1
tibia	shinbone	0
rocket	skyrocket	0
heap	pile	0
dusk	dawn	1
tip	point	0
decline	improvement	1
software	hardware	1
home	personal	0
commander	proconsul	0
classification	declassification	1
plural	singular	1
alertness	wakefulness	0
maintenance	assertion	0
fear	fearlessness	1
tipi	tepee	0
import	export	1
nobody	someone	1
young	old	1
squire	escort	0
justice	jurist	0
auricle	ear	0
augmentation	growth	0
overstatement	understatement	1
track	footprint	0
loosening	tightening	1
check	verification	0
time	clip	0
flashback	analepsis	0
discoloration	stain	0
balance	asymmetry	1
evolution	revolution	1
income	outlay	1
keeping	charge	0
husbandry	farming	0
sunset	daybreak	1
reputation	disrepute	1
duck	eider	0
deep	shallow	1
streetwalker	prostitute	0
width	spaciousness	0
photo	picture	0
career	vocation	0
food	creature	0
leeway	drift	0
preparation	resolution	1
hyperopia	myopia	1
irregular	regular	1
dead	alive	1
figure	ground	1
desegregation	segregation	1
wet	dry	1
digging	region	0
affairs	function	0
nobility	eminence	0
abrasion	attrition	0
event	outcome	0
lock	unlock	1
acquaintance	stranger	1
carol	noel	0
satisfaction	fulfillment	0
roll	roller	0
crossroad	carrefour	0
prosecution	defence	1
pale	red	1
augmentation	diminution	1
cartoon	sketch	0
migration	immigration	0
buy	sale	1
modern	ancient	1
beginning	end	1
institution	education	0
sword	colada	0
acid	base	1
fahrenheit	celsius	1
lawfulness	unlawfulness	1
essential	accessory	1
tray	salver	0
blood	lineage	0
liking	dislike	1
mirror	glass	0
memory	reminiscence	0
founder	builder	0
disk	button	0
union	separation	1
predecessor	successor	1
attraction	repulsion	1
nobody	anybody	1
pizzicato	arco	1
hymn	sing	0
scatter	gather	1
difference	identity	1
compartment	locker	0
death	birth	1
reward	consequence	0
force	stress	0
brass	face	0
hold	guard	0
courage	cowardice	1
dais	pulpit	0
aversion	love	1
maturity	immaturity	1
greeting	salute	0
manner	appearance	0
weakness	strength	1
credit	cash	1
hate	love	1
concept	misconception	1
saddle	col	0
instability	balance	1
bit	coin	0
sound	jangle	0
average	standard	0
danger	safety	1
cultus	cult	0
compound	increase	0
coney	rabbit	0
question	answer	1
seat	stern	0
replication	transcription	1
orchestra	parterre	1
heathen	christian	1
pleasure	solace	0
goblin	hob	0
skip	interval	0
baht	tical	0
nadir	bottom	0
benevolence	malevolence	1
church	kirk	0
sameness	difference	1
loser	success	1
thyrotoxicosis	hyperthyroidism	0
sewing	stitching	0
normality	abnormality	1
burr	bur	0
tour	journey	0
parts	part	0
private	public	1
menopause	menarche	1
whole	sound	0
stand	lie	1
misappropriation	embezzlement	0
signal	noise	1
line	outline	0
treble	bass	1
prison	pit	0
mortarboard	cap	0
item	token	0
cognomen	surname	0
gag	joke	0
mass	assemblage	0
stag	deer	0
disciple	adherent	0
accomplishment	skill	0
postscript	preface	1
transfer	conveyance	0
fiction	fact	1
borrower	lender	1
whiteness	blackness	1
flood	ebb	1
desert	solitude	0
creditor	debtor	1
superior	inferior	1
annulus	ring	0
kindness	generosity	0
entertainment	feast	0
detractor	supporter	1
machine	shape	0
mysticism	quietism	0
enquiry	answer	1
hive	swarm	0
affiliation	association	0
arrangement	settlement	0
superhero	supervillain	1
woodlouse	slater	0
mixture	solution	1
nobody	somebody	1
absolute	perfect	0
sweet	sour	1
night	daytime	1
tissue	muscle	0
blight	blast	0
same	different	1
yawl	sloop	1
judgment	taste	0
hammer	rammer	0
replica	replication	0
spill	spillway	0
satiety	appetite	1
inequality	equality	1
land	domain	0
demand	imposition	0
consideration	attention	0
troop	army	0
beginning	middle	1
comfort	cheer	0
continuity	discontinuity	1
audience	interview	0
handle	hold	0
resignation	surrender	0
distress	comfort	1
home	abode	0
offense	defense	1
conformity	nonconformity	1
imperfect	perfect	1
dishonesty	honesty	1
beam	irradiation	0
intimacy	friendship	0
uncle	aunt	1
like	dislike	1
sanity	madness	1
catabolism	anabolism	1
poem	iambic	0
sore	ulcer	0
backhand	forehand	1
official	private	1
beginning	finish	1
immortality	mortality	1
fertility	sterility	1
likeness	unlikeness	1
notice	placard	0
sampling	pattern	0
confirmation	seal	0
counterpart	duplicate	0
genius	idiot	1
paradox	riddle	0
director	manager	0
anisotropy	isotropy	1
ego	superego	1
antioxidant	oxidant	1
manservant	maidservant	1
habitation	abode	0
pan	portion	0
ober	upper	0
basle	basel	0
shutdown	startup	1
lender	borrower	1
lowland	upland	1
christian	agnostic	1
microstructure	macrostructure	1
municipal	village	0
summer	winter	1
atonement	expiation	0
chip	check	0
tray	server	0
clone	knockoff	0
studio	workroom	0
adult	infant	1
plan	device	0
woman	man	1
fever	term	0
bout	conflict	0
inability	disability	0
nonresident	resident	1
convulsion	spasm	0
appellee	appellant	1
production	performance	0
sequela	result	0
break	rupture	0
works	duty	0
urgency	pressure	0
expression	locution	0
particularity	generality	1
answer	question	1
childhood	maturity	1
explorer	adventurer	0
protagonist	antagonist	1
exportation	importation	1
kernel	essence	0
mhz	megahertz	0
libra	aries	1
shop	garage	0
neocolonialism	colonialism	1
literate	illiterate	1
graduating	student	1
mortality	immortality	1
spirit	intent	0
part	multiple	1
direction	guidance	0
code	codification	0
impurity	purity	1
punk	prostitute	0
parasite	commensal	1
flow	ebb	1
decontamination	contamination	1
tracking	recording	0
stain	blot	0
silence	sound	1
brahma	siva	1
germ	soma	1
sock	buskin	1
inexperience	experience	1
integrator	planimeter	0
sword	scimitar	0
saloon	barroom	0
abundance	deficiency	1
organic	inorganic	1
understanding	agreement	0
mastery	command	0
mold	shape	0
rebel	maverick	0
studio	location	1
colt	filly	0
rivalry	cooperation	1
group	force	0
quiet	peace	0
disassembly	assembly	1
nadir	zenith	1
giver	taker	1
plurality	singularity	1
season	time	0
boarding	disembarkation	1
disposition	mood	0
competition	cooperation	1
awareness	sentience	0
complainant	suspect	1
transitive	intransitive	1
pigeon	gull	0
football	soccer	0
reform	correction	0
pest	plague	0
addition	appendage	0
comfort	encouragement	0
rule	pattern	0
difficulty	ease	1
bear	bull	1
unlawfulness	lawfulness	1
young	mature	1
exporter	importer	1
bark	peel	0
debit	credit	1
saddle	seat	0
periodical	publication	0
cross	traverse	0
human	animal	1
ghost	touch	0
annals	history	0
keep	dungeon	0
employment	underemployment	1
covetousness	greed	0
coffeehouse	cafe	0
substitute	reserve	0
love	angst	1
christian	atheist	1
apex	peak	0
break	hold	1
subordinate	supervisor	1
seed	germ	0
bears	bull	1
generalist	specialist	1
extroversion	introversion	1
regard	scene	0
theatre	theater	0
top	underside	1
glycerin	glycerol	0
circumstance	setting	0
sundown	sunrise	1
pointer	arrow	0
stone	mirror	0
modern	contemporary	0
maleness	femaleness	1
frenzy	rage	0
crossing	crossroad	0
flexor	extensor	1
root	descendent	1
viscosity	fluidity	1
joy	sorrow	1
informality	formality	1
doubt	certainty	1
smile	cry	1
enmity	amity	1
adulthood	childhood	1
scamper	run	0
health	sickness	1
administration	government	0
aunt	niece	1
essay	treatise	0
siege	investment	0
ointment	unguent	0
pain	pleasure	1
unbalance	balance	1
sequel	prequel	1
play	sacrifice	0
foolishness	wisdom	1
standstill	movement	1
missile	ball	0
surcharge	discount	1
birth	demise	1
efflux	influx	1
love	passion	0
marijuana	cannabis	0
landsman	seaman	1
demotion	promotion	1
subsidy	tax	1
nephew	aunt	1
bead	drop	0
downfall	rise	1
parent	child	1
vassal	liegeman	0
crest	top	0
pasture	food	0
resignation	abandonment	0
lightheadedness	dizziness	0
appendix	addition	0
minuscule	majuscule	1
liberal	freethinker	0
spike	ear	0
inconsistency	dissonance	0
finish	ending	0
brahma	vishnu	1
darkness	light	1
face	hero	0
sadist	masochist	1
cockpit	cabin	1
destructor	destroyer	0
presents	future	1
zoology	botany	1
see	diocese	0
cavalryman	hussar	0
real	imaginary	1
small	large	1
last	first	1
cooperation	competition	1
meter	poem	0
single	married	1
destruction	death	0
probability	improbability	1
compression	rarefaction	1
detective	pinkerton	0
writ	precept	0
insanity	sanity	1
distributary	tributary	1
defence	offence	1
respect	consideration	0
bulla	blister	0
borrowing	return	1
upland	swamp	1
rejection	acceptance	1
mentalism	behaviorism	1
senate	legislature	0
outlay	income	1
first	end	1
lateness	earliness	1
flora	fauna	1
calm	serenity	0
synonymy	antonymy	1
sample	specimen	0
embarkation	disembarkation	1
fatalism	determinism	0
lagoon	pond	0
maleness	masculinity	0
daybreak	night	1
guy	girls	1
christian	pagan	1
subsistence	livelihood	0
odontology	dentistry	0
contrary	opponent	0
rind	peel	0
wardrobe	department	0
legislative	executive	1
boyfriend	beau	0
susceptibility	immunity	1
compartment	partition	0
loss	gain	1
evil	goodness	1
niece	uncle	1
exegesis	exposition	0
subway	underground	0
crime	arson	0
statute	edict	0
divorce	marriage	1
grandfather	grandmother	1
majority	minority	1
reading	recitation	0
failure	success	1
shore	coast	0
satisfaction	dissatisfaction	1
extraversion	introversion	1
bit	scrap	0
abridgment	epitome	0
molecule	particle	0
statue	position	0
mannequin	form	0
estate	situation	0
merit	fault	1
paint	draw	0
hind	fore	1
mushroom	toadstool	1
tenet	position	0
thickness	thinness	1
christian	heretic	1
shape	flesh	0
taker	giver	1
puncture	tyre	0
unlikeness	likeness	1
metropolis	center	0
draftee	volunteer	1
fashion	custom	0
brood	breed	0
start	ending	1
inpatient	outpatient	1
lady	mistress	0
reward	reinforcement	0
wealth	poverty	1
export	importation	1
hairdresser	stylist	0
dissent	agreement	1
poem	heroic	0
pleasure	pain	1
judgment	determination	0
mast	mizzenmast	0
west	east	1
limited	local	1
downstairs	upstairs	1
hurt	pain	0
seaweed	dulse	0
rape	force	0
digitigrade	plantigrade	1
nationalisation	privatisation	1
venom	poison	0
price	cost	0
complaint	illness	0
niece	aunt	1
winter	summer	1
adversary	opponent	0
extract	quotation	0
plateau	highland	0
monologue	dialogue	1
cortex	medulla	1
lady	gentleman	1
transitivity	intransitivity	1
penitentiary	prison	0
hollow	tunnel	0
parts	region	0
successor	predecessor	1
unbelief	belief	1
rev	rpm	0
nobleman	lady	1
disequilibrium	equilibrium	1
dominance	control	0
reminiscence	recollection	0
malady	health	1
liberal	conservative	1
metropolis	archbishopric	0
backwardation	contango	1
terrestrial	arboreal	1
invasion	raid	0
acidity	alkalinity	1
benefit	detriment	1
fear	care	0
prison	reformatory	0
instrumentalist	vocalist	1
parole	promise	0
fellow	comrade	0
money	sterling	0
off	leg	1
wreath	chaplet	0
origin	rise	0
exercise	workout	0
simplicity	complexity	1
charlatan	mountebank	0
palaeontology	paleontology	0
specialist	generalist	1
recession	boom	1
esquire	esq	0
physique	figure	0
honesty	dishonesty	1
man	human	0
strength	expertise	0
victory	defeat	1
hunting	search	0
irreverence	reverence	1
fullness	abundance	0
nearness	distance	1
support	oppose	1
apprehension	expectation	0
upturn	downturn	1
mannerism	affectation	0
leeward	windward	1
depiction	picture	0
theism	atheism	1
love	malice	1
condemnation	approbation	1
gray	pearl	0
impermeability	permeability	1
artillery	gun	0
upstroke	downstroke	1
criminalization	decriminalization	1
pack	plot	0
biscuit	hardtack	0
dysgenics	eugenics	1
innocent	criminal	1
file	rank	1
announcement	bulletin	0
neurosis	psychosis	1
plan	project	0
preface	postscript	1
success	loser	1
imperfection	perfection	1
civilian	man	1
upland	marsh	1
chain	range	0
individual	general	1
urea	carbamide	0
speculation	surmise	0
contraindication	indication	1
scandal	outrage	0
pluralism	monism	1
laborer	artisan	1
grandmother	grandfather	1
improbability	probability	1
endeavor	attempt	0
nobody	anyone	1
database	databank	0
tingle	chill	0
people	companions	0
recreation	sport	0
merman	mermaid	1
windward	leeward	1
century	hundred	0
run	rise	1
uncle	aunty	1
warm	cold	1
ingress	egress	1
regional	sectional	0
van	caravan	0
foe	ally	1
legality	illegality	1
separation	unification	1
illegality	legality	1
line	column	1
stand	kneel	1
clash	collision	0
monogyny	polygyny	1
confectionery	candy	0
mortgage	debenture	0
adhesion	cohesion	1
ordinal	cardinal	1
evergreen	deciduous	1
incorrectness	correctness	1
grower	shower	1
specification	spec	0
lizard	dragon	0
mainframe	minicomputer	1
chain	string	0
selfishness	generosity	1
depository	repository	0
focus	center	0
supporter	opponent	1
lead	star	0
wedding	marriage	0
laugh	cry	1
story	account	0
raft	pile	0
niece	nephew	1
asset	liability	1
lagoon	channel	0
gender	kind	0
crown	pennant	0
syrian	syriac	0
shipwright	shipbuilder	0
ingot	pig	0
maximum	minimum	1
acid	alkaline	1
dryness	moisture	1
singular	plural	1
fluorescence	phosphorescence	1
sinkhole	sink	0
replication	replica	0
abnormality	normality	1
advance	retreat	1
competition	contention	0
boon	bane	1
pink	wink	0
rise	downfall	1
volume	roll	0
apparatus	machinery	0
primer	fuse	0
codomain	domain	1
deactivation	activation	1
notice	note	0
worry	trouble	0
tap	spout	0
someone	nobody	1
foyer	vestibule	0
mixture	paste	0
lees	lee	0
illness	wellness	1
petroleum	crude	0
fleet	navy	0
descent	rise	1
wealth	abundance	0
grille	grill	0
agonist	antagonist	1
accolade	award	0
design	plan	0
monopsony	monopoly	1
descent	climb	1
dilution	concentration	1
sugar	bread	0
forest	prairie	1
balance	instability	1
group	army	0
farm	fazenda	0
nothingness	existence	1
racetrack	raceway	0
overachiever	underachiever	1
egoism	altruism	1
government	direction	0
plague	infestation	0
idealist	realist	1
adsorption	absorption	1
debarkation	embarkation	1
goat	nanny	0
haploid	diploid	1
judge	doom	0
youth	elderly	1
inland	border	1
drone	bourdon	0
one	individual	0
malevolence	benevolence	1
quarter	tail	0
maximalist	minimalist	1
prostitute	whore	0
plot	piece	0
hole	projection	1
forward	advanced	0
session	school	0
track	follow	0
permission	prohibition	1
opinion	ruling	0
eugenics	dysgenics	1
cutter	sloop	1
difference	sameness	1
sovereign	prince	0
watershed	landmark	0
resolution	preparation	1
introversion	extroversion	1
inferior	superior	1
pro	amateur	1
operation	procedure	0
conservative	radical	1
tread	rise	1
farewell	greeting	1
fascism	democracy	1
bollock	testicle	0
harpist	harper	0
board	card	0
equality	inequality	1
dissolve	cut	0
hypotension	hypertension	1
alignment	alliance	0
superstar	star	0
route	road	0
form	contract	0
consanguinity	affinity	1
brother	sister	1
embarkation	debarkation	1
adjunct	addition	0
continuity	continuum	0
postposition	preposition	1
data	program	1
suspect	complainant	1
ship	leviathan	0
pact	agreement	0
lobby	antechamber	0
queen	rex	1
dome	building	0
supply	demand	1
man	woman	1
proponent	opponent	1
permeability	impermeability	1
employment	engagement	0
growth	development	0
monomania	insanity	0
shine	play	0
acid	alkali	1
local	limited	1
employment	unemployment	1
immaturity	maturity	1
glass	ice	0
tammy	tam	0
tube	trap	0
amateur	pro	1
apolune	perilune	1
thrill	chill	0
opulence	wealth	0
heterosexual	homosexual	1
warship	battleship	0
theory	speculation	0
daylight	darkness	1
reinforcement	reward	0
first	beginning	0
kitsch	camp	0
antipathy	sympathy	1
overflow	inundation	0
lag	delay	0
pin	duckpin	0
present	absent	1
certainty	uncertainty	1
civilian	serviceman	1
icebox	refrigerator	0
chieftain	chief	0
chase	hunt	0
dissent	assent	1
reservation	booking	0
ellipse	oval	0
generation	progeny	0
war	wage	0
magic	enchantment	0
dissent	consensus	1
speed	delay	1
human	deity	1
show	reveal	0
patriot	traitor	1
inconsistency	consistency	1
disappearance	appearance	1
odds	difference	0
dove	hawk	1
ethos	pathos	1
inquest	question	0
transformation	metamorphosis	0
works	work	0
prohibition	permission	1
estimation	idea	0
light	heavy	1
conspiracy	collusion	0
asymmetry	balance	1
shoot	shot	0
intaglio	cameo	1
impatience	patience	1
liquor	spirits	0
inquiry	answer	1
genius	brilliance	0
clock	ornament	0
fruit	yield	0
attempt	trial	0
balance	symmetry	0
evil	harm	0
orbit	sphere	0
line	covert	0
sensitivity	insensitivity	1
absence	presence	1
season	spice	0
hook	draw	0
iglu	igloo	0
female	male	1
inductor	coil	0
cry	laugh	1
bottom	top	1
peer	nobleman	0
ancestor	forebear	0
tributary	distributary	1
growth	decrease	1
value	price	0
flake	scale	0
estimate	estimation	0
harmony	dissonance	1
commencement	start	0
minority	majority	1
base	noble	1
realisation	recognition	0
catch	drop	1
touchback	safety	1
ebb	flow	1
revulsion	reaction	0
monarch	queen	0
necessity	possibility	1
sunset	dawn	1
plunger	piston	0
badness	goodness	1
cosmonaut	astronaut	0
eats	one	0
resolution	relaxation	0
menarche	menopause	1
cold	hot	1
refuge	sanctuary	0
lord	lady	1
illegitimacy	legitimacy	1
border	margin	0
server	client	1
optics	optic	0
aunt	uncle	1
hothouse	conservatory	0
balance	imbalance	1
subjective	objective	1
myopia	hyperopia	1
comedy	tragedy	1
aquilegia	columbine	0
unwillingness	willingness	1
objectivity	subjectivity	1
noble	lady	1
amity	enmity	1
excretion	secretion	1
authorization	authority	0
impermanence	permanence	1
speck	atom	0
parallelogram	trapezium	1
subtrahend	minuend	1
merger	takeover	1
obstacle	impediment	0
activewear	sportswear	0
intention	counsel	0
luxury	necessity	1
deal	hand	0
treaty	tract	0
length	breadth	1
qualification	change	0
elderly	youth	1
ally	foe	1
finish	start	1
bravery	fear	1
primate	hierarch	0
sunrise	sundown	1
report	sound	0
misfortune	fortune	1
steersman	pilot	0
kickoff	end	1
exogamy	endogamy	1
disgrace	dishonor	0
calamus	shaft	0
member	nonmember	1
trench	deep	0
acyclovir	zovirax	0
parallelism	similarity	0
commencement	rise	0
luck	destiny	0
plantigrade	digitigrade	1
saving	rescue	0
story	tome	0
aggregate	compound	1
nighttime	day	1
liberal	free	0
ray	vision	0
poverty	wealth	1
mode	matter	1
imbalance	balance	1
middle	rim	1
fortification	breastwork	0
park	building	1
guy	gals	1
effect	expression	0
start	finish	1
mortal	immortal	1
realty	personalty	1
specific	general	1
missile	bomb	0
male	female	1
services	capital	1
benefit	gain	0
expression	manifestation	0
atrophy	hypertrophy	1
junction	meeting	0
devil	saint	1
superscript	subscript	1
opponent	advocate	1
reformer	crusader	0
fauna	vegetation	1
movement	motility	0
offence	defense	1
infield	diamond	0
freedom	constraint	1
illness	health	1
regression	progression	1
stead	position	0
masculinity	maleness	0
command	charge	0
warrant	authority	0
push	draw	1
decline	rise	1
popularity	unpopularity	1
chief	main	0
quote	unquote	1
height	depth	1
picture	model	0
adult	juvenile	1
pollution	conservation	1
loggia	veranda	1
appendage	member	0
layman	professional	1
bottle	magnum	0
finger	toy	0
noble	commoner	1
transplantation	transplant	0
pragmatism	idealism	1
inhalation	exhalation	1
neighbour	neighbor	0
inefficiency	efficiency	1
white	black	1
passion	emotion	0
quoin	corner	0
ending	middle	1
lee	weather	1
outfielder	infielder	1
gym	gymnasium	0
raj	reign	0
likeness	portrait	0
debut	unveiling	0
monotheism	polytheism	1
bribe	tip	0
geisha	geiko	0
respect	deference	0
scorn	disdain	0
broth	bouillon	0
consciousness	unconsciousness	1
phrase	idiom	0
founder	author	0
traitor	patriot	1
peace	war	1
complex	complication	0
anticyclone	cyclone	1
angel	darling	0
controversy	debate	0
porter	carrier	0
regularity	irregularity	1
objective	subjective	1
basis	base	0
subordinate	manager	1
love	spite	1
people	class	0
displeasure	pleasure	1
sunrise	sunset	1
zone	circumference	0
soldier	grenadier	0
peak	crown	0
egress	ingress	1
defeat	victory	1
humility	pride	1
descent	decline	0
dignitary	governor	0
open	shut	1
toadstool	mushroom	1
gradation	series	0
rim	middle	1
drinker	abstainer	1
oppression	subjugation	0
dog	weenie	0
hire	fire	1
dwarf	giant	1
descendent	root	1
take	give	1
closeness	openness	1
best	choice	0
arrival	departure	1
height	eminence	0
query	answer	1
din	noise	0
appearance	manifestation	0
highland	lowland	1
swiftness	speed	0
tender	demand	1
creator	creation	1
reason	consideration	0
help	support	0
evidence	deposition	0
notch	indentation	0
split	fissure	0
break	recess	0
ancestor	descendent	1
report	study	0
existence	nonexistence	1
ornament	stripe	1
endogamy	exogamy	1
statics	dynamics	1
spirit	smell	0
consistency	inconsistency	1
row	column	1
seafarer	seaman	0
think	purpose	0
repetition	repeat	0
stockholder	shareholder	0
parallelism	resemblance	0
rise	climb	0
melody	discord	1
disagreement	agreement	1
consonant	vowel	1
negative	affirmative	1
thinness	thickness	1
departure	arrival	1
believer	heretic	1
vagabond	wanderer	0
expiry	end	0
cyclone	anticyclone	1
apparatus	instrument	0
outlet	inlet	1
dielectric	conductor	1
necessity	contingency	1
despair	hope	1
retaliation	retribution	0
revolt	uprising	0
series	parallel	1
fertility	infertility	1
advent	arrival	0
vicinity	neighbourhood	0
endoskeleton	exoskeleton	1
icbm	irbm	1
individual	group	1
affirmative	negative	1
general	specific	1
improvement	decline	1
debris	junk	0
mercury	quicksilver	0
visibility	invisibility	1
motivation	motive	0
ideal	saint	0
bit	number	0
emporium	shop	0
original	remake	1
paint	image	0
insulator	conductor	1
moor	heath	0
trench	fosse	0
centralization	decentralization	1
alkalinity	acidity	1
cut	dock	0
conservative	liberal	1
calling	career	0
branch	sprig	0
obedience	disobedience	1
crescendo	climax	1
day	nighttime	1
region	country	0
merit	demerit	1
celibacy	virginity	0
medal	palm	0
outpatient	inpatient	1
marriage	divorce	1
trace	hint	0
split	schism	0
may	permission	0
country	nation	0
miser	spendthrift	1
consideration	circumstance	0
blessing	curse	1
sphere	field	0
obedience	subservience	0
forehand	backhand	1
supporter	detractor	1
bandit	outlaw	0
summation	addition	0
opponent	proponent	1
story	history	0
fee	charge	0
addition	deduction	1
marriage	matrimony	0
falsity	truth	1
zone	district	0
organisation	brass	0
nonexistence	existence	1
goodness	reality	0
ladies	lord	1
proclivity	tendency	0
complexity	simplicity	1
liberal	radical	0
skirt	border	0
appreciation	taste	0
risc	cisc	1
introversion	extraversion	1
macrocosm	microcosm	1
tightening	loosening	1
contentment	satisfaction	0
pal	mate	0
acid	dose	0
brawl	row	0
confederate	federal	0
prison	roundhouse	0
pursuit	prosecution	0
reverse	obverse	1
ogre	demon	0
incentive	disincentive	1
practice	habit	0
corpuscle	electron	0
wizard	sorcerer	0
hunter	game	1
joint	break	1
serpent	snake	0
sentence	acquittal	1
showing	display	0
clergyman	layman	1
underdog	favorite	1
irrelevance	relevance	1
anger	pleasure	1
syllabus	program	0
former	latter	1
misunderstanding	mistake	0
viewfinder	finder	0
cannabis	weed	0
madam	sir	1
upstairs	downstairs	1
pagan	infidel	0
human	divine	1
overture	coda	1
postgraduate	undergraduate	1
kingdom	rule	0
substantive	adjective	1
violation	trespass	0
extremity	end	0
polygyny	monogamy	1
beneficence	maleficence	1
finish	beginning	1
break	shift	0
collapse	breakdown	0
convergence	divergence	1
realist	idealist	1
vowel	consonant	1
fluidity	solidity	1
quarrel	misunderstanding	0
tiredness	fatigue	0
fear	danger	0
line	feather	0
known	unknown	1
participation	engagement	0
ordinance	preparation	0
stripe	sign	0
lady	nobleman	1
failure	winner	1
wizard	genius	0
falsehood	truth	1
bulk	majority	0
mercy	cruelty	1
squid	calamari	0
true	false	1
sounding	silence	1
pollution	contamination	0
fairway	rough	1
axle	axis	0
ordinance	arrangement	0
soil	land	0
color	species	0
automobile	motorcycle	0
night	day	1
path	footway	0
headpiece	helmet	0
couple	united	0
mass	canon	0
decrease	pay	1
headwind	tailwind	1
advocacy	support	0
statue	colossus	0
theist	atheist	1
substructure	foundation	0
march	advancement	0
seal	sealskin	0
child	parent	1
importation	exportation	1
sanctification	holiness	0
cooperation	rivalry	1
priest	layman	1
poop	bow	1
off	fresh	1
lock	fastening	0
tie	knot	0
patron	customer	0
persecution	prosecution	0
majesty	dignity	0
tag	ticket	0
partition	separation	0
heterogeneity	homogeneity	1
marine	terrestrial	1
scale	pale	0
closet	wardrobe	0
magnate	tycoon	0
illusionist	magician	0
misinterpretation	misunderstanding	0
pace	rack	0
guy	fool	0
airplane	plane	0
shallowness	depth	1
initiation	creation	0
nay	yea	1
everybody	nobody	1
simplicity	difficulty	1
marine	sea	0
polygyny	monogyny	1
analyser	analyzer	0
mail	matter	0
source	seed	0
unrighteousness	righteousness	1
tumult	riot	0
acquittal	conviction	1
opponent	ally	1
control	widget	0
insertion	origin	1
welfare	commonwealth	0
incoherence	coherence	1
star	sensation	0
enemy	ally	1
compositor	typesetter	0
ladder	run	0
sex	gender	0
demand	supply	1
experience	inexperience	1
dissatisfaction	satisfaction	1
citation	quote	0
decrescendo	crescendo	1
uncle	auntie	1
opening	shutting	1
tsar	czar	0
desquamation	peeling	0
savage	wild	0
mystery	form	0
decrease	rise	1
river	abundance	0
plateau	peak	1
track	path	0
stroke	shot	0
colored	negro	0
demise	birth	1
compatibility	incompatibility	1
laugh	giggle	0
intake	outlet	1
stock	fund	0
cavalryman	horseman	0
heart	essence	0
anatomy	build	0
engineer	pioneer	0
ophicleide	serpent	1
can	toilet	0
hypothyroidism	hyperthyroidism	1
initiative	opening	0
rebellion	mutiny	0
affinity	relation	0
cowardice	courage	1
podium	dais	0
condensation	contraction	0
sound	splash	0
accord	agreement	0
discomfort	comfort	1
circuit	course	0
outcome	beginning	1
fiend	monster	0
crash	clash	0
strength	influence	0
misconception	concept	1
opening	closing	1
rearguard	vanguard	1
christian	heathen	1
goodness	righteousness	0
opportunity	turn	0
carina	ridge	0
meat	drink	1
rim	body	1
frame	shape	0
unconsciousness	consciousness	1
mydriasis	miosis	1
vertebrate	invertebrate	1
tip	top	0
notification	notice	0
income	expenditure	1
piece	item	0
appeal	recourse	0
day	night	1
whisper	shout	1
understanding	sense	0
wisdom	dexterity	0
handle	ear	0
revolution	evolution	1
vacation	rest	0
pullback	pushout	1
forward	backward	1
blacklist	whitelist	1
try	trial	0
wrath	vengeance	0
redress	remedy	0
east	west	1
defence	offense	1
telephone	phone	0
missile	dart	0
tissue	web	0
fun	sport	0
student	dig	0
cat	tommy	0
assembly	disassembly	1
park	skyscraper	1
stain	grease	0
contingency	option	0
stockpile	reserve	0
barbarian	rude	0
folly	wisdom	1
retail	wholesale	1
regular	irregular	1
cruelty	mercy	1
duel	holmgang	0
fate	freedom	1
foundation	institution	0
modernity	modernism	0
truth	falsity	1
open	closed	1
forest	woodland	0
fullness	emptiness	1
change	shift	0
gizzard	stomach	0
sieve	drum	0
oasis	island	0
tackle	attack	0
ground	figure	1
compact	treaty	0
trustee	grantor	1
backup	support	0
request	demand	0
see	seat	0
perilune	apolune	1
light	swift	0
spell	trance	0
uncle	niece	1
loot	pillage	0
reader	referee	0
student	teacher	1
mobilization	demobilization	1
public	private	1
consonance	harmony	0
capitalism	socialism	1
plastic	elastic	1
objective	target	0
picture	exposure	0
static	dynamic	1
masochist	sadist	1
oxidant	antioxidant	1
symmetry	asymmetry	1
trace	track	0
fanaticism	enthusiasm	0
result	follow	0
bull	bear	1
haw	gee	1
conception	misconception	1
individual	collective	1
sunup	sundown	1
footrace	run	0
disembarkation	embarkation	1
poll	top	0
noise	silence	1
obstacle	barrage	0
nation	land	0
event	business	0
voluntarism	intellectualism	1
favorite	least	1
august	aug	0
river	anabranch	0
recto	verso	1
extensor	flexor	1
fearlessness	fear	1
check	control	0
duet	twain	0
sister	brother	1
pattern	model	0
longbow	crossbow	1
truth	falsehood	1
readiness	quickness	0
ceiling	floor	1
alias	pseudonym	0
violation	infringement	0
sapwood	heartwood	1
whip	lash	0
highbrow	lowbrow	1
craft	strength	0
consonance	dissonance	1
source	sink	1
expenditure	income	1
ectoparasite	endoparasite	1
fold	enclosure	0
widening	narrowing	1
kit	kitten	0
ability	inability	1
gullet	esophagus	0
woman	dowager	0
mariner	sailor	0
air	information	0
closeness	remoteness	1
dislike	like	1
payment	evasion	1
design	idea	0
monkey	mangabey	0
glut	shortage	1
approval	disapproval	1
corona	circle	0
scandal	slander	0
depot	terminal	0
whole	party	1
man	beast	1
cimetidine	tagamet	0
pool	bethesda	0
middle	start	1
desert	barren	0
incompatibility	compatibility	1
start	middle	1
hunger	satiety	1
irregularity	regularity	1
queue	join	0
casket	reliquary	0
unreliability	reliability	1
settlement	adjustment	0
blackness	whiteness	1
figure	physique	0
exarchate	eparchy	0
grandmother	grandchild	1
parting	departure	0
open	public	0
grand	small	1
premium	discount	1
adaptation	fitness	0
report	description	0
heterosexuality	homosexuality	1
dependence	independence	1
additive	subtractive	1
disrespect	respect	1
rise	decline	1
face	nerve	0
satiety	hunger	1
underground	metro	0
command	behest	0
willingness	unwillingness	1
automobile	machine	0
sway	influence	0
demobilization	mobilization	1
buy	sell	1
success	failure	1
antagonist	competitor	0
ending	finish	0
irrational	rational	1
disclaimer	claim	1
noblewoman	nobleman	1
denim	dungaree	0
luxation	dislocation	0
euphemism	dysphemism	1
space	walk	0
ament	catkin	0
shopping	studio	0
reading	interpretation	0
realm	division	0
descendent	ancestor	1
permit	permission	0
depreciation	appreciation	1
park	street	1
creationism	traducianism	1
inspiration	expiration	1
gap	break	0
disembarkation	boarding	1
tragedy	comedy	1
lee	lie	0
staff	personnel	0
present	future	1
comedy	drama	1
humility	modesty	0
pro	con	1
centrifugal	centripetal	1
marshland	marsh	0
euphoria	dysphoria	1
encouragement	discouragement	1
hog	swine	0
disability	strength	1
generality	particularity	1
resolution	decision	0
appeal	collection	0
undress	dress	1
player	actor	0
express	local	1
importation	export	1
patronage	custom	0
proprietor	owner	0
ease	difficulty	1
perigee	apogee	1
femininity	masculinity	1
behaviour	behavior	0
cosmetic	paint	0
segregation	integration	1
perfection	imperfection	1
lip	labium	0
subscript	superscript	1
grease	fat	0
disposition	propensity	0
middleman	broker	0
pond	cistern	0
stanza	englyn	0
triumph	conquest	0
gelatin	jelly	0
heteronomy	autonomy	1
desire	grief	0
misconception	conception	1
quiet	loud	1
actualization	realization	0
keno	bingo	0
drink	drinking	0
priest	pontifex	0
resistance	impedance	0
opposite	contrary	0
scarcity	abundance	1
authorship	composition	0
modern	old	1
pitcher	mound	0
rim	center	1
offering	gift	0
reliability	unreliability	1
integration	segregation	1
domain	dominion	0
pattern	rule	0
copy	original	1
poetry	prose	1
hobo	vagabond	0
idiot	genius	1
stable	mew	0
goods	services	1
comfort	discomfort	1
layman	clergyman	1
burning	combustion	0
dissimilarity	similarity	1
local	global	1
eye	regard	0
creator	creature	1
decrease	growth	1
excursion	expedition	0
shoal	sandbank	0
decade	ten	0
ornament	grace	0
king	monarch	0
socialism	capitalism	1
blow	shock	0
obverse	reverse	1
preparation	grooming	0
righteousness	unrighteousness	1
short	long	1
watchtower	beacon	0
gap	spread	0
artificial	natural	1
context	isolation	1
stock	standard	0
decline	incline	1
specific	universal	1
wart	verruca	0
screen	blind	0
furze	gorse	0
rancho	hacienda	1
behemoth	monster	0
avenue	boulevard	0
patience	impatience	1
base	nucleotide	0
childhood	age	1
fate	choice	1
garbage	resource	1
monism	pluralism	1
oral	written	1
atheism	theism	1
rich	poor	1
ledge	bench	0
dramaturgy	theater	0
barbarism	culture	1
deposition	precipitation	0
hash	hashish	0
disapproval	approval	1
courses	class	0
parts	section	0
crew	group	0
assembly	dismantling	1
dysphemism	euphemism	1
battleship	liner	0
warm	cool	1
bay	alcove	0
stadium	arena	1
denial	prosecution	1
retail	report	0
lord	suzerain	0
vortex	eddy	0
domain	codomain	1
buckle	bow	0
sorrow	joy	1
union	pairing	0
prairie	forest	1
play	gaming	0
honesty	goodness	0
messenger	courier	0
rostrum	pulpit	0
apogee	perigee	1
hardness	softness	1
monogamy	polygamy	1
strength	weakness	1
humour	comedy	0
row	sequence	0
compact	agreement	0
joy	mirth	0
nearsightedness	farsightedness	1
slowness	clumsiness	0
resident	nonresident	1
center	essence	0
layman	expert	1
end	beginning	1
teletypewriter	teleprinter	0
series	chain	0
love	hate	1
export	import	1
position	stead	0
goodness	badness	1
arbitration	decision	0
wrongness	rightness	1
offense	defence	1
end	destruction	0
contest	competition	0
large	small	1
conduct	direction	0
nephew	uncle	1
touch	trace	0
hope	fear	1
prosecution	denial	1
femaleness	maleness	1
adsorption	desorption	1
affinity	consanguinity	1
blow	punch	0
gain	loss	1
new	old	1
conclusion	beginning	1
commencement	end	1
overgrowth	undergrowth	1
appreciation	depreciation	1
fact	actuality	0
medulla	cortex	1
eyes	center	0
anticline	syncline	1
inability	ability	1
residence	abode	0
disguise	mask	0
guard	care	0
worshipper	believer	0
good	benefit	0
unification	separation	1
northeast	southwest	1
framing	frame	0
cut	track	0
shooter	firearm	0
center	midpoint	0
end	middle	1
amateur	professional	1
paralysis	paraplegia	0
polygamy	monogamy	1
giant	heavyweight	0
joint	junction	0
banknote	note	0
micron	micrometre	0
trade	custom	0
man	civilian	1
pride	humility	1
relevance	irrelevance	1
nobody	everyone	1
nothing	something	1
uncle	nephew	1
epinephrine	adrenalin	0
sickness	health	1
crescendo	diminuendo	1
dose	pill	0
endoparasite	ectoparasite	1
distance	interval	1
wisdom	foolishness	1
maintenance	continuation	0
auditorium	orchestra	0
gas	petrol	0
earliness	lateness	1
disadvantage	drawback	0
eye	middle	0
end	remainder	0
aunty	uncle	1
middle	first	1
mode	custom	0
unveiling	debut	0
devil	angel	1
antagonist	protagonist	1
documentary	fiction	1
interrogation	answer	1
auntie	uncle	1
polygyny	polyandry	1
destruction	annihilation	0
proponent	detractor	1
fold	boundary	0
dislike	liking	1
professional	amateur	1
layman	priest	1
bad	good	1
chemise	shift	0
lowbrow	highbrow	1
caress	kiss	0
conduct	construction	0
wife	husband	1
tablet	pad	0
crime	robbery	0
peer	noble	0
forest	wood	0
indentation	inlet	0
immortal	mortal	1
sound	chime	0
hundred	century	0
watermill	windmill	1
war	peace	1
openness	closeness	1
run	running	0
goliath	giant	0
cover	screening	0
kid	parent	1
domestic	foreign	1
specific	generic	1
guilt	innocence	1
sterility	fertility	1
mercury	spirit	0
legitimacy	illegitimacy	1
conjunct	disjunct	1
conspiracy	disagreement	1
helm	director	0
smack	slap	0
aversion	distaste	0
fore	aft	1
hunter	forager	0
sundown	sunup	1
pest	nuisance	0
hope	despair	1
gentry	aristocracy	0
womanhood	woman	0
minister	parson	0
person	body	0
breed	crossbreed	0
bolt	dart	0
binary	ascii	1
theism	pantheism	1
remoteness	closeness	1
underestimate	overestimate	1
configuration	figure	0
matter	form	1
champion	hero	0
mouth	lip	0
balance	unbalance	1
believer	worshipper	0
jerk	press	1
midwife	obstetrician	0
laundry	washing	0
health	illness	1
daybreak	sunset	1
dissipation	diffusion	0
placebo	nocebo	1
cladode	phylloclade	0
design	create	0
room	seat	0
phase	state	0
daytime	nighttime	1
glory	pride	0
detriment	benefit	1
internal	external	1
black	white	1
cornflour	cornstarch	0
goblin	demon	0
microbe	microorganism	0
dwelling	cottage	0
lowness	highness	1
endurance	suffering	0
stack	pile	1
devil	god	1
boulevard	road	0
beginning	ending	1
origin	beginning	0
aunt	nephew	1
infielder	outfielder	1
infantry	cavalry	1
satan	adversary	0
prostitution	degradation	0
new	ancient	1
party	person	0
correspondence	symmetry	0
acquittal	sentence	1
truth	nonsense	1
separation	union	1
misbehavior	behavior	0
regent	ruler	0
sink	decrease	0
roll	collar	0
climb	descent	1
epicenter	hypocenter	1
liability	asset	1
weaponry	munition	0
emptiness	fullness	1
autonomy	heteronomy	1
microcosm	macrocosm	1
height	stature	0
brethren	sister	1
weakening	strengthening	1
cut	steak	0
convent	monastery	0
palimony	alimony	1
shout	whisper	1
runner	stolon	0
approbation	condemnation	1
rationalism	traditionalism	1
doctrine	teaching	0
dissimilation	assimilation	1
gardener	nurseryman	0
black	descent	0
distress	anxiety	0
pathos	ethos	1
milk	buttermilk	0
aunty	aunt	0
nobody	everybody	1
neighborhood	region	0
strainer	filter	0
posting	bill	0
serbia	srbija	0
pleasantness	unpleasantness	1
downtime	uptime	1
excavation	tunnel	1
shaft	beam	0
roman	italic	1
crew	member	0
transition	passing	0
past	future	1
grape	niagara	0
lord	overlord	0
source	beginning	0
cubicle	stall	0
balloon	toy	0
oracle	seer	0
engagement	mesh	0
top	base	1
demeanor	conduct	0
ebb	flood	1
marketer	vendor	0
office	post	0
capacity	competency	0
dystopia	utopia	1
microcomputer	minicomputer	1
purity	impurity	1
necessity	luxury	1
soldier	redcoat	0
mail	spot	0
strait	difficulty	0
tick	check	0
section	whole	1
capitalism	communism	1
permanence	impermanence	1
disincentive	incentive	1
constituent	ingredient	0
binary	text	1
exploitation	development	0
location	studio	1
dissolution	solution	0
individual	joint	1
sprout	shoot	0
defense	offense	1
fellatio	cunnilingus	1
individualism	selfishness	0
opportunity	space	0
lens	magnifier	0
puzzle	teaser	0
checkin	checkout	1
liabilities	asset	1
loudness	softness	1
daytime	night	1
fauna	flora	1
discount	surcharge	1
denominator	numerator	1
district	tract	0
lead	hint	0
illiterate	literate	1
nap	napoleon	0
hoop	ring	0
onslaught	attack	0
credit	debit	1
husband	wife	1
membrane	caul	0
syrinx	panpipe	0
hammer	helve	0
proverb	drama	0
beauty	ugliness	1
set	band	0
contamination	decontamination	1
writer	author	0
lumper	splitter	1
voice	whisper	0
whig	tory	1
prince	monarch	0
fils	pere	1
torture	pleasure	1
imperfection	defect	0
luck	portion	0
cyclopedia	encyclopedia	0
imperfective	perfective	1
union	coupling	0
minority	bulk	1
cation	anion	1
withdrawal	deposit	1
local	universal	1
sachem	sagamore	0
first	middle	1
con	pro	1
hook	bait	0
decentralization	centralization	1
conductor	dielectric	1
good	goodness	0
abstraction	generalization	0
fluidity	viscosity	1
reality	unreality	1
formula	rule	0
softness	hardness	1
respect	disrespect	1
remedy	help	0
nitrocellulose	guncotton	0
maximization	minimization	1
segregation	desegregation	1
base	apex	1
prosecution	defense	1
default	payment	1
spike	spindle	0
pamphlet	tract	0
balance	comparison	0
thought	attention	0
journeyman	apprentice	1
exon	intron	1
hypertrophy	atrophy	1
mode	variety	0
momentum	moment	0
core	rom	1
unemployment	employment	1
thrombosis	embolism	1
substance	center	0
truth	inaccuracy	1
hypertension	hypotension	1
existence	nothingness	1
junior	senior	1
compression	decompression	1
functioning	office	0
no.	yes	1
similarity	dissimilarity	1
design	sketch	0
ship	frigate	0
altruism	egoism	1
centrist	moderate	0
legend	tale	0
husband	lord	0
dementia	insanity	0
old	ancient	0
bunker	trap	0
explosion	implosion	1
north	union	0
meiosis	mitosis	1
consciousness	sensibility	0
answer	enquiry	1
original	copy	1
diploid	polyploid	1
unpopularity	popularity	1
fascism	liberalism	1
healer	therapist	0
solidity	fluidity	1
conductor	insulator	1
rage	madness	0
break	discipline	0
theme	topic	0
poor	rich	1
structure	edifice	0
partner	opponent	1
germ	seed	0
forgiveness	mercy	0
smoker	nonsmoker	1
solution	problem	1
nothing	anything	1
subtraction	addition	1
chronicle	annals	0
symbol	totem	0
grant	gift	0
female	woman	0
post	billet	0
imaging	value	0
preface	preamble	0
ally	enemy	1
disrepute	reputation	1
layman	specialist	1
mass	magnitude	0
wholesale	retail	1
difficulty	simplicity	1
automobile	tractor	0
fortification	citadel	0
consonant	dental	0
priest	hierophant	0
hall	bower	1
mind	body	1
wood	timber	0
work	lead	0
phenomenon	noumenon	1
crown	corona	0
doubt	ambiguity	0
pedestal	base	0
payment	default	1
defence	denial	0
disability	ability	1
thing	matter	0
thief	pickpocket	0
spite	water	0
victory	loss	1
everything	nothing	1
outfield	infield	1
dawn	sunset	1
woman	womanhood	0
change	transform	0
presence	absence	1
opponent	partner	1
chicken	male	0
horror	repulsion	0
slate	flake	0
mason	bricklayer	0
notebook	exercise	0
sham	fake	0
sweet	dry	1
deceiver	impostor	0
smack	crack	0
wellness	illness	1
rabbit	bunny	0
round	group	0
cracking	fracture	0
rostrum	podium	0
hyperthyroidism	hypothyroidism	1
learning	acquisition	0
thick	thin	1
chairwoman	chairman	0
middle	beginning	1
efficiency	inefficiency	1
light	darkness	1
shallow	deep	1
land	realm	0
smooth	rough	1
courier	messenger	0
middle	border	1
triumph	defeat	1
proper	common	1
thermometer	glass	0
avocation	business	0
homogeneity	heterogeneity	1
diol	glycol	0
hand	straight	0
tautology	contradiction	1
prisoner	culprit	0
justice	injustice	1
volunteer	draftee	1
organisation	administration	0
evasion	payment	1
juvenile	adult	1
original	reproduction	1
formation	production	0
keepsake	souvenir	0
profit	loss	1
dysfunction	function	1
apology	justification	0
sanity	insanity	1
unreality	reality	1
mixture	variety	0
guillemot	murre	0
nonsmoker	smoker	1
coupler	coupling	0
bargain	contract	0
madness	sanity	1
lover	fan	0
top	bottom	1
circle	orb	0
speaking	oratory	0
seriousness	sincerity	0
step	track	0
mind	opinion	0
disobedience	obedience	1
open	close	1
hyperbole	exaggeration	0
ambo	pulpit	0
intermediary	mean	0
natural	artificial	1
visage	face	0
age	era	0
posturing	attitude	0
merger	acquisition	1
hymn	troparion	0
stake	picket	0
waterfall	cascade	0
assets	liabilities	1
collapse	downfall	0
agreement	disagreement	1
flux	fusion	0
deduction	addition	1
carpenter	joiner	0
borrowing	transfer	1
disqualification	qualification	1
periphery	center	1
second	assistant	0
volunteer	conscript	1
lady	lord	1
interpretation	translation	0
approval	sanction	0
tapestry	arras	0
verso	recto	1
sleeping	waking	1
bench	workbench	0
exaggeration	understatement	1
contingency	necessity	1
tax	assessment	0
fate	chance	0
foetus	fetus	0
bulk	minority	1
lifo	fifo	1
ideal	motif	0
addition	subtraction	1
mindfulness	body	1
advance	aid	0
estate	dignity	0
deceit	guile	0
aggregation	accumulation	0
unitarian	trinitarian	1
outgroup	ingroup	1
childbirth	death	1
colt	filly	1
throw	throwing	0
narrowing	widening	1
incivility	civility	1
future	past	1
anabolism	catabolism	1
downturn	upturn	1
eddy	swirl	0
sky	cloud	0
polygala	milkwort	0
moisture	dryness	1
sink	source	1
highness	lowness	1
affluence	poverty	1
guile	cunning	0
heretic	believer	1
frog	french	1
long	short	1
establishment	settlement	0
finite	infinite	1
cockroach	roach	0
enjoyment	satisfaction	0
masculinity	femininity	1
dissonance	harmony	1
makeup	constitution	0
invisible	visible	1
preliminary	final	1
subordinate	chief	1
trance	spell	0
lightness	darkness	1
understatement	overstatement	1
conductance	resistance	1
joiner	carpenter	0
flooring	floor	0
appearance	disappearance	1
attendee	audience	0
strengthening	weakening	1
immersion	emersion	1
midget	dwarf	1
hyperthermia	hypothermia	1
cleaver	chopper	0
revival	renewal	0
rusk	zwieback	0
uncertainty	certainty	1
floor	ceiling	1
degeneration	development	1
offer	offering	0
abundance	scarcity	1
salient	projection	0
infield	outfield	1
future	present	1
maleficence	beneficence	1
outcome	source	1
minimization	maximization	1
serviceman	civilian	1
enmity	love	1
label	tag	0
curtilage	court	0
drink	tea	0
nephew	niece	1
opportunity	scope	0
coherence	incoherence	1
echo	answer	0
loggia	porch	1
rise	descent	1
cool	warm	1
upland	meadow	1
conviction	acquittal	1
offense	offence	0
impingement	impact	0
king	queen	1
planter	pioneer	0
wisdom	folly	1
food	bit	0
honesty	purity	0
voice	steven	0
function	secant	0
conservative	progressive	1
wife	concubine	0
implosion	explosion	1
nobleman	noblewoman	1
lowland	highland	1
pace	tempo	0
demise	lease	0
activation	deactivation	1
health	malady	1
disability	potential	1
blanket	cover	0
suffragette	suffragist	0
accordance	conformity	0
mono	stereo	1
district	ward	0
apparel	costume	0
share	division	0
ilium	troy	0
answer	query	1
night	daylight	1
vocalist	instrumentalist	1
root	beginning	0
restoration	restitution	0
eucharist	communion	0
police	officers	0
humor	comedy	0
monotony	variety	1
distemper	illness	0
fundamental	element	0
insensitivity	sensitivity	1
node	antinode	1
negligence	care	1
tailwind	headwind	1
demon	daemon	0
iron	ferrous	0
proportion	scale	0
defense	prosecution	1
injustice	justice	1
transubstantiation	consubstantiation	1
senior	junior	1
quoin	cornerstone	0
fracture	shift	0
fortune	misfortune	1
room	chamber	0
cash	credit	1
lord	vassal	1
answer	interrogation	1
neglect	carelessness	0
milestone	landmark	0
frown	smile	1
opportunity	time	0
polytheism	monotheism	1
prevention	aid	1
good	evil	1
monism	dualism	1
pleasure	displeasure	1
lightness	heaviness	1
start	end	1
certainty	doubt	1
diminution	augmentation	1
observation	remark	0
prose	verse	1
magic	wizardry	0
horse	jack	0
antinode	node	1
zip	sound	0
tragedy	burlesque	1
breach	break	0
indication	contraindication	1
violence	force	0
wit	brain	0
fastening	fastener	0
tower	spire	0
birth	death	1
nonconformity	conformity	1
contango	backwardation	1
guy	gal	1
realm	sphere	0
field	bat	1
dry	wet	1
mica	isinglass	0
middle	end	1
insertion	deletion	1
conservative	revolutionary	1
shaft	barb	0
invisibility	visibility	1
horn	spike	0
rope	twine	0
disability	capacity	1
origin	insertion	1
unpleasantness	pleasantness	1
start	finishing	1
good	bad	1
hypothermia	hyperthermia	1
utopia	dystopia	1
potty	toilet	0
truth	lie	1
cast	fashion	0
revolt	insurrection	0
respect	admiration	0
shortage	glut	1
local	express	1
overestimate	underestimate	1
crown	reward	0
whites	black	1
discharge	explosion	0
parcel	tract	0
civility	incivility	1
moderate	extreme	1
appoggiatura	acciaccatura	0
maidservant	manservant	1
accusation	acquittal	1
pot	marijuana	0
formality	informality	1
conscript	volunteer	1
dry	water	1
lament	sorrow	0
darkness	lightness	1
proclamation	declaration	0
rightness	wrongness	1
polarisation	polarization	0
strength	stress	0
category	tribe	0
sunset	sunrise	1
miosis	mydriasis	1
bane	boon	1
two	deuce	0
immunity	susceptibility	1
stay	hold	0
dish	beauty	0
decriminalization	criminalization	1
opponent	supporter	1
rope	sheet	0
crescendo	decrescendo	1
correctness	incorrectness	1
dysphoria	euphoria	1
hawk	dove	1
failure	deterioration	0
degeneration	regeneration	1
tissue	membrane	0
diminuendo	crescendo	1
white	cracker	0
adjective	substantive	1
remainder	end	0
nonmember	member	1
consonant	labial	0
chapel	chantry	0
railroad	rail	0
buck	single	0
nothing	everything	1
lord	husband	0
understudy	standby	0
services	good	1
